1111111111111111
1P100000000000E1
1010111111111001
1C101C1C00000001
1010001000011111
1010101111000001
101C100001010001
1011111101010C01
1000000101011111
1111011101010C01
1C00000000000001
1111111111111111